subject	inch	sell	trouble
bark	orbit	time	cannot
beneath	diagram	surrounded	spin
sometime	won	sister	quite
motion	imagine	swimming	huge
definition	tie	fastened	operation
hello	condition	reader	bound
north	glad	rear	must
duty	country	package	flat
fine	speech	health	rising
gently	myself	tired	familiar
customs	split	push	stronger
must	hang	answer	dream
former	space	around	quietly
work	themselves	sport	wonderful
feed	shot	were	rope
shirt	popular	separate	regular
full	fighting	needs	climate
development	block	comfortable	knowledge
worth	age	shells	shore
